NO asset/textures/free.png
SO asset/textures/hassan3.png
WE asset/textures/wall.png
EA asset/textures/sh.png

F 200,100,100
C 4,33,6
1 1 1
1111 
11W11
1111  
1 1 1
